오다	To come	
마시다	To drink	
먹다	To eat	
주다	To give	
가다	To go	
듣다	To hear	
배우다	To learn	
만들다	To make	
앉다	To sit	
자다	To sleep	
씻다	To wash	
쓰다	To write	
울다	To cry	
갖다	To have	
웃다	To laugh	
보다	To see	
일어나다	To get up	
걷다	To walk	
춤추다	To dance	
만나다	To meet	
공부하다	To study	
운전하다	To drive	
사다	To buy	
읽다	To read	
주문하다	To order	
입다	To wear	
찍다	To take (picture)	
쓰다	To wear (hat, eyewear)	
신다	To wear (shoes, socks, footwear)	
빌리다	To borrow, lend	
전화하다	To telephone	
말하다	To talk, speak	
가르치다	To teach	
기다리다	To wait	
걸다	To call, dial	
청소하다	To clean	
타다	To ride	
나가다	To exit	
들어오다	To enter	
물어보다	To ask	
필요하다	To need	
도와주다	To help	
열다	To open	
닫다	To close	
일하다	To work	
쉬다	To rest	
운동하다	To exercise	
생각하다	To think	
알다	To know	
모르다	To not know	
요리하다	To cook	
끓이다	To boil	
썰다	To chop, slice	
튀기다	To deep fry	
재다	To measure, weigh	
섞다	To mix, blend	
굽다	To roast, grill, bake	
볶다	To fry	
찌다	To steam	
휘젓다	To stir	
하다	To do	
있다	To have	
없다	To not have	
이야기하다	To talk, chat	
연습하다	To practice	
묻다	To ask	
내다	To pay	
살다	To live	
죽다	To die	
태어나다	To be born	
사랑하다	To love	
좋아하다	To like	
싫어하다	To hate, dislike	
결혼하다	To marry	
축하하다	To congratulate	
걱정하다	To worry	
약속하다	To promise	
거짓말하다	To lie	
고백하다	To confess	
죄송하다	To be sorry	
찾다	To find, to look for	
준비하다	To prepare	
가지다	To have	
기억하다	To remember	
꿈꾸다	To dream	
시작하다	To start	
끝나다	To finish	
보내다	To send	
사용하다	To use	
팔다	To sell	
싸우다	To fight	
대답하다	To answer	
소개하다	To introduce	
출발하다	To depart	
도착하다	To arrive	
벗다	To undress, take off clothes	
이기다	To win, defeat	
지다	To lose, be defeated	
서두르다	To hurry, rush	
사랑에 빠지다	To fall in love	